# -----------------------------------------
# Syntax colouring
# -----------------------------------------

# Datatypes (such as objects)
RSD	KEYWORD1
Channel	KEYWORD1
Screen	KEYWORD1
draw	KEYWORD1

#Methods / functions
begin	KEYWORD2
update	KEYWORD2
line	KEYWORD2
fill	KEYWORD2
clear	KEYWORD2
get	KEYWORD2
lineSafe	KEYWORD2
fillSafe	KEYWORD2
clearSafe	KEYWORD2
getSafe	KEYWORD2
copy	KEYWORD2
attachChannel	KEYWORD2
attachDraw	KEYWORD2
getTick	KEYWORD2
getFine	KEYWORD2
getPeriod	KEYWORD2
getFrequency	KEYWORD2
getLowerTick	KEYWORD2
getHigherTick	KEYWORD2
getLowerFine	KEYWORD2
getHigherFine	KEYWORD2
setTick	KEYWORD2
setFine	KEYWORD2
shiftPhase	KEYWORD2

# Constants
BWIDTH	LITERAL1
WIDTH	LITERAL1
COMMON_CATHODE	LITERAL1
COMMON_ANODE	LITERAL1
BLACK	LITERAL1
RED	LITERAL1
GREEN	LITERAL1
BLUE	LITERAL1
YELLOW	LITERAL1
CYAN	LITERAL1
MAGENTA	LITERAL1
WHITE	LITERAL1
colour	LITERAL1
frameCount	LITERAL1
frameLost	LITERAL1
